accDefRate,accExamCnt,accExamCompCnt,careCnt,clearCnt,createDt,deathCnt,decideCnt,examCnt,resutlNegCnt,seq,stateDt,stateTime,updateDt,decideDailyCnt
5.557315,109591,75792,,31,2020-03-02 10:52:38.380,22,4212,33799,71580,61,2020-03-02 00:00:00.000,00:00,2020-03-02 10:52:38.38,476
5.3291397,125851,90296,4159,34,2020-03-03 10:46:53.530,28,4812,35555,85484,62,2020-03-03 00:00:00.000,00:00,2020-03-03 10:46:53.53,600
4.919986,136707,108293,4750,41,2020-03-04 10:21:44.440,32,5328,28414,102965,63,2020-03-04 00:00:00.000,00:00,2020-03-04 10:21:44.44,516
4.6227484,146541,124731,5255,88,2020-03-05 10:15:12.120,35,5766,21810,118965,64,2020-03-05 00:00:00.000,00:00,2020-03-05 10:15:12.12,438
4.3972344,164740,142908,5643,108,2020-03-06 12:55:44.440,42,6284,21832,136624,65,2020-03-06 00:00:00.000,00:00,2020-03-06 12:55:44.44,518
4.267543,178189,158569,6134,118,2020-03-07 11:00:45.450,44,6767,19620,151802,66,2020-03-07 00:00:00.000,00:00,2020-03-07 11:00:45.45,483
4.2177577,188518,169142,6605,130,2020-03-08 11:16:27.270,50,7134,19376,162008,67,2020-03-08 00:00:00.000,00:00,2020-03-08 11:16:27.27,367
4.1203394,196618,179160,6954,166,2020-03-09 10:47:15.150,51,7382,17458,171778,68,2020-03-09 00:00:00.000,00:00,2020-03-09 10:47:15.15,248
3.919308,210144,191692,7165,247,2020-03-10 10:20:27.270,54,7513,18452,184179,69,2020-03-10 00:00:00.000,00:00,2020-03-10 10:20:27.27,131
3.8041744,222395,203855,7212,288,2020-03-11 10:17:19.190,60,7755,18540,196100,70,2020-03-11 00:00:00.000,00:00,2020-03-11 10:17:19.19,242
3.6217442,234998,217271,7407,333,2020-03-12 10:37:03.030,66,7869,17727,209402,71,2020-03-12 00:00:00.000,00:00,2020-03-12 10:37:03.03,114
3.4584992,248647,230707,7470,510,2020-03-13 10:07:22.220,67,7979,17940,222728,72,2020-03-13 00:00:00.000,00:00,2020-03-13 10:07:22.22,110
3.3180003,261335,243701,7402,714,2020-03-14 10:29:11.110,72,8086,17634,235615,73,2020-03-14 00:00:00.000,00:00,2020-03-14 10:29:11.11,107
3.2396603,268212,251940,7300,834,2020-03-15 10:01:22.220,75,8162,16272,243778,74,2020-03-15 00:00:00.000,00:00,2020-03-15 10:01:22.22,76
3.1733923,274504,259533,7253,1137,2020-03-16 10:12:33.330,75,8236,14971,251297,75,2020-03-16 00:00:00.000,00:00,2020-03-16 10:12:33.33,74
3.088058,286716,269425,7024,1401,2020-03-17 10:29:38.380,81,8320,17291,261105,76,2020-03-17 00:00:00.000,00:00,2020-03-17 10:29:38.38,84
3.0121624,295647,279301,6838,1540,2020-03-18 10:26:15.150,84,8413,16346,270888,77,2020-03-18 00:00:00.000,00:00,2020-03-18 10:26:15.15,93
2.9420857,307024,291120,6789,1947,2020-03-19 10:07:57.570,91,8565,15904,282555,78,2020-03-19 00:00:00.000,00:00,2020-03-19 10:07:57.57,152
2.873092,316664,301139,6527,2233,2020-03-20 10:15:59.590,94,8652,15525,292487,79,2020-03-20 00:00:00.000,00:00,2020-03-20 10:15:59.59,87
2.821956,327509,311805,6325,2612,2020-03-21 10:02:58.580,102,8799,15704,303006,80,2020-03-21 00:00:00.000,00:00,2020-03-21 10:02:58.58,147
2.8045013,331780,317240,6085,2909,2020-03-22 10:07:28.280,104,8897,14540,308343,81,2020-03-22 00:00:00.000,00:00,2020-03-22 10:07:28.28,98
2.7622623,338036,324408,5884,3166,2020-03-23 10:27:32.320,111,8961,13628,315447,82,2020-03-23 00:00:00.000,00:00,2020-03-23 10:27:32.32,64
2.712657,348582,333142,5684,3507,2020-03-24 10:20:57.570,120,9037,15440,324105,84,2020-03-24 00:00:00.000,00:00,2020-03-24 10:20:57.57,76
2.6590574,357896,343618,5410,3730,2020-03-25 10:12:04.040,126,9137,14278,334481,85,2020-03-25 00:00:00.000,00:00,2020-03-25 10:12:04.04,100
2.6359704,364942,350573,5281,4144,2020-03-26 10:40:50.500,131,9241,14369,341332,86,2020-03-26 00:00:00.000,00:00,2020-03-26 10:40:50.50,104
2.579739,376961,361742,4966,4528,2020-03-27 10:17:01.010,139,9332,15219,352410,87,2020-03-27 00:00:00.000,00:00,2020-03-27 10:17:01.01,91
2.5522335,387925,371361,4665,4811,2020-03-28 10:30:06.060,144,9478,16564,361883,88,2020-03-28 00:00:00.000,00:00,2020-03-28 10:30:06.06,146
2.5277424,394141,379113,4523,5033,2020-03-29 10:10:20.200,152,9583,15028,369530,89,2020-03-29 00:00:00.000,00:00,2020-03-29 10:10:20.20,105
2.5312908,395194,381663,4398,5228,2020-03-30 10:32:34.340,158,9661,13531,372002,90,2020-03-30 00:00:00.000,00:00,2020-03-30 10:32:34.34,78
2.4858258,410564,393672,4275,5408,2020-03-31 11:00:44.440,162,9786,16892,383886,91,2020-03-31 00:00:00.000,00:00,2020-03-31 11:00:44.44,125
2.4414637,421547,404962,4216,5567,2020-04-01 10:13:22.220,165,9887,16585,395075,92,2020-04-01 00:00:00.000,00:00,2020-04-01 10:13:22.22,101
2.4104886,431743,413858,4155,5828,2020-04-02 10:13:00.000,169,9976,17885,403882,94,2020-04-02 00:00:00.000,00:00,2020-04-02 10:13:00.00,89
2.371072,443273,424365,3979,6021,2020-04-03 10:19:21.210,174,10062,18908,414303,95,2020-04-03 00:00:00.000,00:00,2020-04-03 10:19:21.21,86
2.335314,455032,434888,3867,6325,2020-04-04 10:32:51.510,177,10156,20144,424732,96,2020-04-04 00:00:00.000,00:00,2020-04-04 10:32:51.51,94
2.3178358,461233,441662,3654,6463,2020-04-05 10:11:59.590,183,10237,19571,431425,97,2020-04-05 00:00:00.000,00:00,2020-04-05 10:11:59.59,81
2.2980545,466804,447509,3591,6598,2020-04-06 10:27:44.440,186,10284,19295,437225,98,2020-04-06 00:00:00.000,00:00,2020-04-06 10:27:44.44,47
2.2623255,477304,456654,3500,6694,2020-04-07 10:12:25.250,192,10331,20650,446323,99,2020-04-07 00:00:00.000,00:00,2020-04-07 10:12:25.25,47
2.2181163,486003,468145,3445,6776,2020-04-08 10:15:42.420,200,10384,17858,457761,100,2020-04-08 00:00:00.000,00:00,2020-04-08 10:15:42.42,53
2.1750743,494711,479202,3408,6973,2020-04-09 10:22:27.270,204,10423,15509,468779,101,2020-04-09 00:00:00.000,00:00,2020-04-09 10:22:27.27,39
2.1424778,503051,487753,3246,7117,2020-04-10 10:15:54.540,208,10450,15298,477303,102,2020-04-10 00:00:00.000,00:00,2020-04-10 10:15:54.54,27
2.1111624,510479,496409,3125,7243,2020-04-11 10:24:11.110,211,10480,14070,485929,103,2020-04-11 00:00:00.000,00:00,2020-04-11 10:24:11.11,30
2.0989032,514621,500833,3026,7368,2020-04-12 10:20:49.490,214,10512,13788,490321,104,2020-04-12 00:00:00.000,00:00,2020-04-12 10:20:49.49,32
2.0850813,518743,505352,2930,7447,2020-04-13 10:14:53.530,217,10537,13391,494815,105,2020-04-13 00:00:00.000,00:00,2020-04-13 10:14:53.53,25
2.0601146,527438,512787,2873,7534,2020-04-14 10:23:15.150,222,10564,14651,502223,106,2020-04-14 00:00:00.000,00:00,2020-04-14 10:23:15.15,27
2.038589,534552,519526,2808,7616,2020-04-15 11:34:34.340,225,10591,15026,508935,107,2020-04-15 00:00:00.000,00:00,2020-04-15 11:34:34.34,27
2.023424,538775,524507,2750,7757,2020-04-16 10:55:17.170,229,10613,14268,513894,108,2020-04-16 00:00:00.000,00:00,2020-04-16 10:55:17.17,22
1.9980198,546463,532277,2627,7829,2020-04-17 10:32:02.020,230,10635,14186,521642,109,2020-04-17 00:00:00.000,00:00,2020-04-17 10:32:02.02,22
1.968098,554834,541284,2576,7937,2020-04-18 10:44:12.120,232,10653,13550,530631,110,2020-04-18 00:00:00.000,00:00,2020-04-18 10:44:12.12,18
1.9494721,559109,546866,2484,8042,2020-04-19 10:27:30.300,234,10661,12243,536205,111,2020-04-19 00:00:00.000,00:00,2020-04-19 10:27:30.30,8
1.9370153,563035,551054,2385,8114,2020-04-20 10:26:59.590,236,10674,11981,540380,112,2020-04-20 00:00:00.000,00:00,2020-04-20 10:26:59.59,13
1.9135114,571014,558293,2324,8213,2020-04-21 10:11:58.580,237,10683,12721,547610,113,2020-04-21 00:00:00.000,00:00,2020-04-21 10:11:58.58,9
1.8899403,577959,565838,2233,8277,2020-04-22 10:20:28.280,238,10694,12121,555144,114,2020-04-22 00:00:00.000,00:00,2020-04-22 10:20:28.28,11
1.8650057,583971,573832,2179,8411,2020-04-23 10:11:05.050,240,10702,10139,563130,115,2020-04-23 00:00:00.000,00:00,2020-04-23 10:11:05.05,8
1.8464615,589520,579920,2051,8501,2020-04-24 10:11:08.080,240,10708,9600,569212,116,2020-04-24 00:00:00.000,00:00,2020-04-24 10:11:08.08,6
1.8293161,595161,585902,1967,8635,2020-04-25 10:58:08.080,240,10718,9259,575184,119,2020-04-25 00:00:00.000,00:00,2020-04-25 10:58:08.08,10
1.8205082,598285,589286,1843,8717,2020-04-26 10:12:24.240,242,10728,8999,578558,120,2020-04-26 00:00:00.000,00:00,2020-04-26 10:12:24.24,10
1.8115104,601660,592765,1769,8764,2020-04-27 10:12:27.270,243,10738,8895,582027,121,2020-04-27 00:00:00.000,00:00,2020-04-27 10:12:27.27,10
1.7940602,608514,599311,1731,8854,2020-04-28 10:22:16.160,244,10752,9203,588559,122,2020-04-28 00:00:00.000,00:00,2020-04-28 10:22:16.16,14
1.776065,614197,605890,1654,8922,2020-04-29 10:26:00.000,246,10761,8307,595129,123,2020-04-29 00:00:00.000,00:00,2020-04-29 10:26:00.00,9
1.7611538,619881,611247,1593,9059,2020-04-30 10:12:42.420,247,10765,8634,600482,124,2020-04-30 00:00:00.000,00:00,2020-04-30 10:12:42.42,4
1.7536263,623069,614384,1459,9072,2020-05-01 10:24:38.380,248,10774,8685,603610,125,2020-05-01 00:00:00.000,00:00,2020-05-01 10:24:38.38,9
1.7413329,627562,619066,1454,9123,2020-05-02 10:22:19.190,250,10780,8496,608286,126,2020-05-02 00:00:00.000,00:00,2020-05-02 10:22:19.19,6
1.7341356,630973,622385,1407,9183,2020-05-03 10:54:37.370,250,10793,8588,611592,127,2020-05-03 00:00:00.000,00:00,2020-05-03 10:54:37.37,13
1.7261025,633921,625745,1360,9217,2020-05-04 10:11:32.320,252,10801,8176,614944,128,2020-05-04 00:00:00.000,00:00,2020-05-04 10:11:32.32,8
1.7111751,640237,631379,1332,9283,2020-05-05 10:20:41.410,254,10804,8858,620575,129,2020-05-05 00:00:00.000,00:00,2020-05-05 10:20:41.41,3
1.7015018,643095,635086,1267,9333,2020-05-06 10:16:11.110,255,10806,8009,624280,130,2020-05-06 00:00:00.000,00:00,2020-05-06 10:16:11.11,2
1.6865354,649388,640959,1218,9419,2020-05-07 10:43:56.560,256,10810,8429,630149,131,2020-05-07 00:00:00.000,00:00,2020-05-07 10:43:56.56,4
1.6752425,654863,645996,1135,9484,2020-05-08 10:18:50.500,256,10822,8867,635174,132,2020-05-08 00:00:00.000,00:00,2020-05-08 10:18:50.50,12
1.6654452,660030,650877,1082,9568,2020-05-09 10:17:15.150,256,10840,9153,640037,133,2020-05-09 00:00:00.000,00:00,2020-05-09 10:17:15.15,18
1.6633066,663886,653758,1016,9610,2020-05-10 10:14:56.560,256,10874,10128,642884,134,2020-05-10 00:00:00.000,00:00,2020-05-10 10:14:56.56,34
1.6589869,668492,657570,1008,9632,2020-05-11 10:25:58.580,256,10909,10922,646661,135,2020-05-11 00:00:00.000,00:00,2020-05-11 10:25:58.58,35
1.6456001,680890,664560,1021,9670,2020-05-12 10:12:14.140,258,10936,16330,653624,136,2020-05-12 00:00:00.000,00:00,2020-05-12 10:12:14.14,27
1.62078,695920,676341,1008,9695,2020-05-13 10:41:15.150,259,10962,19579,665379,137,2020-05-13 00:00:00.000,00:00,2020-05-13 10:41:15.15,26
1.5911413,711484,690762,1008,9762,2020-05-14 10:18:25.250,260,10991,20722,679771,138,2020-05-14 00:00:00.000,00:00,2020-05-14 10:18:25.25,29
1.558698,726747,706872,969,9821,2020-05-15 10:33:34.340,260,11018,19875,695854,139,2020-05-15 00:00:00.000,00:00,2020-05-15 10:33:34.34,27
1.5280312,740645,722302,937,9851,2020-05-16 10:19:44.440,262,11037,18343,711265,140,2020-05-16 00:00:00.000,00:00,2020-05-16 10:19:44.44,19
1.5137131,747653,729993,924,9888,2020-05-17 10:12:11.110,262,11050,17660,718943,141,2020-05-17 00:00:00.000,00:00,2020-05-17 10:12:11.11,13
1.5011165,753211,737118,900,9904,2020-05-18 10:18:09.090,263,11065,16093,726053,142,2020-05-18 00:00:00.000,00:00,2020-05-18 10:18:09.09,15
1.4797322,765574,748649,898,9938,2020-05-19 10:22:38.380,263,11078,16925,737571,143,2020-05-19 00:00:00.000,00:00,2020-05-19 10:22:38.38,13
1.4616843,776433,760082,877,10066,2020-05-20 10:13:17.170,263,11110,16351,748972,144,2020-05-20 00:00:00.000,00:00,2020-05-20 10:13:17.17,32
1.4433004,788684,770595,781,10135,2020-05-21 10:24:07.070,264,11122,18089,759473,145,2020-05-21 00:00:00.000,00:00,2020-05-21 10:24:07.07,12
1.4245677,802418,782132,723,10162,2020-05-22 10:15:38.380,264,11142,20286,770990,146,2020-05-22 00:00:00.000,00:00,2020-05-22 10:15:38.38,20
1.4082091,814420,792851,716,10194,2020-05-23 10:34:54.540,266,11165,21569,781686,147,2020-05-23 00:00:00.000,00:00,2020-05-23 10:34:54.54,23
1.398827,820289,799956,705,10213,2020-05-24 10:29:10.100,266,11190,20333,788766,148,2020-05-24 00:00:00.000,00:00,2020-05-24 10:29:10.10,25
1.3880012,826437,807348,711,10226,2020-05-25 10:27:08.080,267,11206,19089,796142,149,2020-05-25 00:00:00.000,00:00,2020-05-25 10:27:08.08,16
1.3732046,839475,817431,713,10275,2020-05-26 10:12:49.490,269,11225,22044,806206,150,2020-05-26 00:00:00.000,00:00,2020-05-26 10:12:49.49,19
1.3542675,852876,831815,681,10295,2020-05-27 10:16:33.330,269,11265,21061,820550,151,2020-05-27 00:00:00.000,00:00,2020-05-27 10:16:33.33,40
1.3404293,868666,846296,701,10340,2020-05-28 10:11:28.280,269,11344,22370,834952,152,2020-05-28 00:00:00.000,00:00,2020-05-28 10:11:28.28,79
1.3249465,885120,860563,735,10363,2020-05-29 10:10:53.530,269,11402,24557,849161,153,2020-05-29 00:00:00.000,00:00,2020-05-29 10:10:53.53,58
1.3051518,902901,876603,770,10398,2020-05-30 10:12:27.270,269,11441,26298,865162,154,2020-05-30 00:00:00.000,00:00,2020-05-30 10:12:27.27,39
1.2921282,910822,887528,774,10405,2020-05-31 10:22:38.380,270,11468,23294,876060,155,2020-05-31 00:00:00.000,00:00,2020-05-31 10:22:38.38,27
1.2819098,921391,897333,793,10422,2020-06-01 10:13:10.100,271,11503,24058,885830,156,2020-06-01 00:00:00.000,00:00,2020-06-01 10:13:10.10,35
1.2669483,939851,910929,810,10446,2020-06-02 10:15:46.460,272,11541,28922,899388,157,2020-06-02 00:00:00.000,00:00,2020-06-02 10:15:46.46,38
1.2475955,956852,928987,823,10467,2020-06-03 10:25:46.460,273,11590,27865,917397,158,2020-06-03 00:00:00.000,00:00,2020-06-03 10:25:46.46,49
1.2297244,973858,945659,850,10499,2020-06-04 10:27:46.460,273,11629,28199,934030,159,2020-06-04 00:00:00.000,00:00,2020-06-04 10:27:46.46,39
1.2126453,990960,962194,857,10506,2020-06-05 10:56:51.510,273,11668,28766,950526,160,2020-06-05 00:00:00.000,00:00,2020-06-05 10:56:51.51,39
1.1990575,1005305,977351,889,10531,2020-06-06 10:49:23.230,273,11719,27954,965632,161,2020-06-06 00:00:00.000,00:00,2020-06-06 10:49:23.23,51
1.1939718,1012769,986288,915,10552,2020-06-07 10:20:09.090,273,11776,26481,974512,162,2020-06-07 00:00:00.000,00:00,2020-06-07 10:20:09.09,57
1.1886231,1018213,993839,951,10563,2020-06-08 10:14:01.010,273,11813,24374,982026,163,2020-06-08 00:00:00.000,00:00,2020-06-08 10:14:01.01,37
1.1750685,1035996,1008537,977,10589,2020-06-09 10:08:46.460,274,11851,27459,996686,164,2020-06-09 00:00:00.000,00:00,2020-06-09 10:08:46.46,38
1.1602265,1051971,1025748,988,10611,2020-06-10 10:13:48.480,276,11901,26223,1013847,165,2020-06-10 00:00:00.000,00:00,2020-06-10 10:13:48.48,50
1.1471174,1066887,1041393,1014,10654,2020-06-11 10:30:28.280,276,11946,25494,1029447,166,2020-06-11 00:00:00.000,00:00,2020-06-11 10:30:28.28,45
1.1352179,1081486,1057242,1016,10669,2020-06-12 10:22:23.230,277,12002,24244,1045240,167,2020-06-12 00:00:00.000,00:00,2020-06-12 10:22:23.23,56
1.1247481,1094703,1071351,1056,10691,2020-06-13 10:11:43.430,277,12050,23352,1059301,168,2020-06-13 00:00:00.000,00:00,2020-06-13 10:11:43.43,48
1.119956,1100327,1078971,1082,10718,2020-06-14 10:19:18.180,277,12084,21356,1066887,169,2020-06-14 00:00:00.000,00:00,2020-06-14 10:19:18.18,34
1.1172191,1105719,1084926,1089,10730,2020-06-15 10:16:22.220,277,12121,20793,1072805,170,2020-06-15 00:00:00.000,00:00,2020-06-15 10:16:22.22,37
1.1078855,1119767,1097135,1114,10760,2020-06-16 10:16:47.470,278,12155,22632,1084980,171,2020-06-16 00:00:00.000,00:00,2020-06-16 10:16:47.47,34
1.0975999,1132823,1111334,1117,10774,2020-06-17 10:14:34.340,279,12198,21489,1099136,172,2020-06-17 00:00:00.000,00:00,2020-06-17 10:14:34.34,43
1.0904824,1145712,1123998,1145,10800,2020-06-18 10:12:45.450,280,12257,21714,1111741,173,2020-06-18 00:00:00.000,00:00,2020-06-18 10:12:45.45,59
1.0824428,1158063,1136873,1177,10835,2020-06-19 10:32:24.240,280,12306,21190,1124567,174,2020-06-19 00:00:00.000,00:00,2020-06-19 10:32:24.24,49
1.0764457,1170901,1149431,1191,10856,2020-06-20 10:14:22.220,280,12373,21470,1137058,175,2020-06-20 00:00:00.000,00:00,2020-06-20 10:14:22.22,67
1.0741167,1176463,1156392,1237,10868,2020-06-21 10:10:23.230,280,12421,20071,1143971,176,2020-06-21 00:00:00.000,00:00,2020-06-21 10:10:23.23,48
1.0697855,1182066,1162663,1273,10881,2020-06-22 11:40:11.110,280,12438,19403,1150225,177,2020-06-22 00:00:00.000,00:00,2020-06-22 11:40:11.11,17
1.0636141,1196012,1173734,1277,10908,2020-06-23 10:41:14.140,281,12484,22278,1161250,178,2020-06-23 00:00:00.000,00:00,2020-06-23 10:41:14.14,46
1.0548221,1208597,1188352,1295,10930,2020-06-24 10:31:43.430,281,12535,20245,1175817,179,2020-06-24 00:00:00.000,00:00,2020-06-24 10:31:43.43,51
1.0455418,1220478,1201578,1324,10974,2020-06-25 10:19:09.090,282,12563,18900,1189015,180,2020-06-25 00:00:00.000,00:00,2020-06-25 10:19:09.09,28
1.0384948,1232315,1213487,1307,11172,2020-06-26 10:13:35.350,282,12602,18828,1200885,181,2020-06-26 00:00:00.000,00:00,2020-06-26 10:13:35.35,39
1.0338144,1243780,1223914,1148,11317,2020-06-27 10:47:05.050,282,12653,19866,1211261,182,2020-06-27 00:00:00.000,00:00,2020-06-27 10:47:05.05,51
1.031484,1251695,1232690,1054,11364,2020-06-28 10:29:27.270,282,12715,19005,1219975,183,2020-06-28 00:00:00.000,00:00,2020-06-28 10:29:27.27,62
1.0275846,1259954,1241455,1069,11429,2020-06-29 10:29:36.360,282,12757,18499,1228698,184,2020-06-29 00:00:00.000,00:00,2020-06-29 10:29:36.36,42
1.0215044,1273765,1252956,1046,11537,2020-06-30 11:19:14.140,282,12799,20809,1240157,185,2020-06-30 00:00:00.000,00:00,2020-06-30 11:19:14.14,42
1.0152445,1285231,1265705,980,11613,2020-07-01 10:35:06.060,282,12850,19526,1252855,186,2020-07-01 00:00:00.000,00:00,2020-07-01 10:35:06.06,51
1.0111426,1295962,1276180,955,11684,2020-07-02 10:27:03.030,282,12904,19782,1263276,187,2020-07-02 00:00:00.000,00:00,2020-07-02 10:27:03.03,54
1.0080073,1307761,1286201,938,11759,2020-07-03 10:19:08.080,282,12965,21560,1273236,188,2020-07-03 00:00:00.000,00:00,2020-07-03 10:19:08.08,61
1.004317,1319521,1297200,924,11811,2020-07-04 10:13:42.420,283,13028,22321,1284172,189,2020-07-04 00:00:00.000,00:00,2020-07-04 10:13:42.42,63
1.0034453,1326055,1304406,934,11832,2020-07-05 10:25:26.260,283,13089,21649,1291317,190,2020-07-05 00:00:00.000,00:00,2020-07-05 10:25:26.26,61
1.0024388,1331796,1310504,974,11848,2020-07-06 10:42:20.200,284,13137,21292,1297367,191,2020-07-06 00:00:00.000,00:00,2020-07-06 10:42:20.20,48
0.9966586,1346194,1322519,1005,11914,2020-07-07 10:15:15.150,285,13181,23675,1309338,192,2020-07-07 00:00:00.000,00:00,2020-07-07 10:15:15.15,44
0.9914488,1359734,1335722,982,11970,2020-07-08 10:19:47.470,285,13243,24012,1322479,193,2020-07-08 00:00:00.000,00:00,2020-07-08 10:19:47.47,62
0.98623073,1371771,1347859,988,12019,2020-07-09 10:50:30.300,287,13293,23912,1334566,194,2020-07-09 00:00:00.000,00:00,2020-07-09 10:50:30.30,50
0.9797534,1384890,1361363,987,12065,2020-07-10 10:16:35.350,288,13338,23527,1348025,195,2020-07-10 00:00:00.000,00:00,2020-07-10 10:16:35.35,45
0.97329605,1396941,1373991,985,12144,2020-07-11 10:24:20.200,288,13373,22950,1360618,196,2020-07-11 00:00:00.000,00:00,2020-07-11 10:24:20.20,35
0.9720252,1402144,1380314,941,12178,2020-07-12 10:21:53.530,289,13417,21830,1366897,197,2020-07-12 00:00:00.000,00:00,2020-07-12 10:21:53.53,44
0.9721832,1408312,1386467,950,12204,2020-07-13 10:20:52.520,289,13479,21845,1372988,198,2020-07-13 00:00:00.000,00:00,2020-07-13 10:20:52.52,62
0.96768165,1420616,1396327,986,12282,2020-07-14 10:42:52.520,289,13512,24289,1382815,199,2020-07-14 00:00:00.000,00:00,2020-07-14 10:42:52.52,33
0.962416,1431316,1408019,941,12348,2020-07-15 10:38:15.150,289,13551,23297,1394468,200,2020-07-15 00:00:00.000,00:00,2020-07-15 10:38:15.15,39
0.9599815,1441348,1417944,914,12396,2020-07-16 10:44:38.380,291,13612,23404,1404332,201,2020-07-16 00:00:00.000,00:00,2020-07-16 10:44:38.38,61
0.9574853,1451017,1427907,925,12460,2020-07-17 10:40:49.490,293,13672,23110,1414235,202,2020-07-17 00:00:00.000,00:00,2020-07-17 10:40:49.49,60
0.95395404,1460204,1437281,919,12519,2020-07-18 10:13:21.210,294,13711,22923,1423570,203,2020-07-18 00:00:00.000,00:00,2020-07-18 10:13:21.21,39
0.9523011,1465299,1443346,898,12556,2020-07-19 10:19:04.040,295,13745,21953,1429601,204,2020-07-19 00:00:00.000,00:00,2020-07-19 10:19:04.04,34
0.9504511,1470193,1448891,894,12572,2020-07-20 10:55:20.200,296,13771,21302,1435120,205,2020-07-20 00:00:00.000,00:00,2020-07-20 10:55:20.20,26
0.9472577,1482390,1458526,903,12643,2020-07-21 11:07:32.320,296,13816,23864,1444710,206,2020-07-21 00:00:00.000,00:00,2020-07-21 11:07:32.32,45
0.94394416,1492071,1470320,877,12698,2020-07-22 10:27:17.170,297,13879,21751,1456441,207,2020-07-22 00:00:00.000,00:00,2020-07-22 10:27:17.17,63
0.9421158,1500854,1479436,884,12758,2020-07-23 10:38:02.020,297,13938,21418,1465498,208,2020-07-23 00:00:00.000,00:00,2020-07-23 10:38:02.02,59
0.93833405,1510327,1489768,883,12817,2020-07-24 11:05:48.480,298,13979,20559,1475789,209,2020-07-24 00:00:00.000,00:00,2020-07-24 11:05:48.48,41
0.94012284,1518634,1498953,864,12866,2020-07-25 10:19:50.500,298,14092,19681,1484861,210,2020-07-25 00:00:00.000,00:00,2020-07-25 10:19:50.50,113
0.94100463,1522926,1503712,928,12890,2020-07-26 10:28:24.240,298,14150,19214,1489562,211,2020-07-26 00:00:00.000,00:00,2020-07-26 10:28:24.24,58
0.93985957,1526974,1508204,962,12905,2020-07-27 10:35:55.550,299,14175,18770,1494029,212,2020-07-27 00:00:00.000,00:00,2020-07-27 10:35:55.55,25
0.93609536,1537704,1517260,971,13007,2020-07-28 10:31:12.120,300,14203,20444,1503057,213,2020-07-28 00:00:00.000,00:00,2020-07-28 10:31:12.12,28
0.9326687,1547307,1527981,896,13069,2020-07-29 10:44:55.550,300,14251,19326,1513730,214,2020-07-29 00:00:00.000,00:00,2020-07-29 10:44:55.55,48
0.928248,1556215,1537197,882,13132,2020-07-30 11:11:23.230,300,14269,19018,1522928,215,2020-07-30 00:00:00.000,00:00,2020-07-30 11:11:23.23,18
0.9256108,1563796,1545466,837,13183,2020-07-31 10:36:45.450,301,14305,18330,1531161,216,2020-07-31 00:00:00.000,00:00,2020-07-31 10:36:45.45,36
0.92278856,1571830,1553552,821,13233,2020-08-01 10:20:04.040,301,14336,18278,1539216,217,2020-08-01 00:00:00.000,00:00,2020-08-01 10:20:04.04,31
0.9217968,1576246,1558478,802,13259,2020-08-02 12:17:01.010,301,14366,17768,1544112,218,2020-08-02 00:00:00.000,00:00,2020-08-02 12:17:01.01,30
0.9209809,1579757,1562356,806,13280,2020-08-03 10:22:38.380,301,14389,17401,1547967,219,2020-08-03 00:00:00.000,00:00,2020-08-03 10:22:38.38,23
0.9180449,1589780,1571056,808,13352,2020-08-04 10:49:59.590,301,14423,18724,1556633,220,2020-08-04 00:00:00.000,00:00,2020-08-04 10:49:59.59,34
0.9151122,1598187,1579697,770,13406,2020-08-05 10:20:58.580,302,14456,18490,1565241,221,2020-08-05 00:00:00.000,00:00,2020-08-05 10:20:58.58,33
0.91277313,1606487,1588456,748,13501,2020-08-06 10:22:47.470,302,14499,18031,1573957,222,2020-08-06 00:00:00.000,00:00,2020-08-06 10:22:47.47,43
0.909379,1613652,1596584,696,13543,2020-08-07 10:11:43.430,303,14519,17068,1582065,223,2020-08-07 00:00:00.000,00:00,2020-08-07 10:11:43.43,20
0.90762395,1620514,1604409,673,13629,2020-08-08 10:18:57.570,304,14562,16105,1589847,224,2020-08-08 00:00:00.000,00:00,2020-08-08 10:18:57.57,43
0.9079222,1624650,1607847,629,13642,2020-08-09 10:42:32.320,305,14598,16803,1593249,225,2020-08-09 00:00:00.000,00:00,2020-08-09 10:42:32.32,36
0.9073725,1628303,1611907,651,13658,2020-08-10 10:37:49.490,305,14626,16396,1597281,226,2020-08-10 00:00:00.000,00:00,2020-08-10 10:37:49.49,28
0.90474004,1637844,1620355,663,13729,2020-08-11 10:28:37.370,305,14660,17489,1605695,227,2020-08-11 00:00:00.000,00:00,2020-08-11 10:28:37.37,34
0.90309995,1646652,1629277,626,13786,2020-08-12 10:41:22.220,305,14714,17375,1614563,228,2020-08-12 00:00:00.000,00:00,2020-08-12 10:41:22.22,54
0.9022051,1654898,1637100,623,13817,2020-08-13 10:26:13.130,305,14770,17798,1622330,229,2020-08-13 00:00:00.000,00:00,2020-08-13 10:26:13.13,56
0.90416014,1665084,1644952,648,13863,2020-08-14 10:25:20.200,305,14873,20132,1630079,230,2020-08-14 00:00:00.000,00:00,2020-08-14 10:25:20.20,103
0.90942734,1675296,1653678,705,13901,2020-08-15 09:04:10.100,305,15039,21618,1638639,231,2020-08-15 00:00:00.000,00:00,2020-08-15 9:04:10.10,166
0.9228923,1681787,1659782,833,13910,2020-08-16 10:33:31.310,305,15318,22005,1644464,232,2020-08-16 00:00:00.000,00:00,2020-08-16 10:33:31.31,279
0.9315487,1688470,1665506,1103,13917,2020-08-18 09:12:23.230,305,15515,22964,1649991,233,2020-08-17 00:00:00.000,00:00,2020-08-18 9:12:23.23,197
0.94274336,1697042,1671823,1293,13934,2020-08-18 10:13:01.010,306,15761,25219,1656062,234,2020-08-18 00:00:00.000,00:00,2020-08-18 10:13:01.01,246
0.9535392,1715064,1684042,1521,14006,2020-08-19 10:12:19.190,306,16058,31022,1667984,235,2020-08-19 00:00:00.000,00:00,2020-08-19 10:12:19.19,297
0.9620472,1734083,1699085,1746,14063,2020-08-20 10:13:53.530,307,16346,34998,1682739,236,2020-08-20 00:00:00.000,00:00,2020-08-20 10:13:53.53,288
0.9714011,1754123,1716078,1976,14120,2020-08-21 10:21:10.100,309,16670,38045,1699408,237,2020-08-21 00:00:00.000,00:00,2020-08-21 10:21:10.10,324
0.98086214,1775800,1733373,2241,14169,2020-08-22 10:15:56.560,309,17002,42427,1716371,238,2020-08-22 00:00:00.000,00:00,2020-08-22 10:15:56.56,332
0.99780804,1791186,1743622,2524,14200,2020-08-23 10:21:59.590,309,17398,47564,1726224,239,2020-08-23 00:00:00.000,00:00,2020-08-23 10:21:59.59,396
1.005678,1804422,1756427,2889,14219,2020-08-24 10:17:44.440,309,17664,47995,1738763,240,2020-08-24 00:00:00.000,00:00,2020-08-24 10:17:44.44,266
1.0106591,1825837,1775475,3136,14286,2020-08-25 10:23:00.000,310,17944,50362,1757531,241,2020-08-25 00:00:00.000,00:00,2020-08-25 10:23:00.00,280
1.0165241,1849506,1796711,3348,14368,2020-08-26 10:20:54.540,312,18264,52795,1778447,242,2020-08-26 00:00:00.000,00:00,2020-08-26 10:20:54.54,320
1.0291394,1869579,1817538,3584,14461,2020-08-27 10:15:47.470,313,18705,52041,1798833,243,2020-08-27 00:00:00.000,00:00,2020-08-27 10:15:47.47,441
1.0384288,1887717,1837006,3931,14551,2020-08-28 09:39:46.460,316,19076,50711,1817930,244,2020-08-28 00:00:00.000,00:00,2020-08-28 9:39:46.46,371
1.0456086,1909329,1855283,4209,14765,2020-08-29 09:56:02.020,321,19399,54046,1835884,245,2020-08-29 00:00:00.000,00:00,2020-08-29 9:56:02.02,323
1.0555427,1924170,1866149,4313,14903,2020-08-30 09:37:35.350,323,19698,58021,1846451,246,2020-08-30 00:00:00.000,00:00,2020-08-30 9:37:35.35,299
1.0610629,1937689,1879813,4472,14973,2020-08-31 09:32:30.300,324,19946,57876,1859867,247,2020-08-31 00:00:00.000,00:00,2020-08-31 9:32:30.30,248
1.060853,1959080,1902337,4649,15198,2020-09-01 09:32:28.280,324,20181,56743,1882156,248,2020-09-01 00:00:00.000,00:00,2020-09-01 9:32:28.28,235
1.0630362,1980295,1923547,4659,15356,2020-09-02 10:20:18.180,326,20448,56748,1903099,249,2020-09-02 00:00:00.000,00:00,2020-09-02 10:20:18.18,267
1.0613215,2000552,1945028,4766,15529,2020-09-03 09:37:36.360,329,20643,55524,1924385,250,2020-09-03 00:00:00.000,00:00,2020-09-03 9:37:36.36,195
1.0597262,2018906,1966640,4785,15783,2020-09-04 09:46:41.410,331,20841,52266,1945799,251,2020-09-04 00:00:00.000,00:00,2020-09-04 9:46:41.41,198
1.0584049,2037045,1984968,4727,16008,2020-09-05 09:34:12.120,333,21009,52077,1963959,252,2020-09-05 00:00:00.000,00:00,2020-09-05 9:34:12.12,168
1.060755,2045935,1996314,4668,16145,2020-09-06 09:48:31.310,334,21176,49621,1975138,253,2020-09-06 00:00:00.000,00:00,2020-09-06 9:48:31.31,167
1.062525,2051297,2004188,4697,16296,2020-09-07 09:34:32.320,336,21295,47109,1982893,254,2020-09-07 00:00:00.000,00:00,2020-09-07 9:34:32.32,119
1.0595202,2066078,2022708,4663,16635,2020-09-08 09:34:17.170,341,21431,43370,2001277,255,2020-09-08 00:00:00.000,00:00,2020-09-08 9:34:17.17,136
1.0552373,2082234,2045701,4455,17022,2020-09-09 10:04:45.450,344,21587,36533,2024114,256,2020-09-09 00:00:00.000,00:00,2020-09-09 10:04:45.45,156
1.0520799,2099591,2066573,4221,17359,2020-09-10 09:43:45.450,346,21742,33018,2044831,257,2020-09-10 00:00:00.000,00:00,2020-09-10 9:43:45.45,155
1.0488145,2119211,2089788,4037,17615,2020-09-11 09:34:22.220,350,21918,29423,2067870,258,2020-09-11 00:00:00.000,00:00,2020-09-11 9:34:22.22,176
1.0463881,2135457,2107631,3953,18028,2020-09-12 10:03:20.200,355,22054,27826,2085577,259,2020-09-12 00:00:00.000,00:00,2020-09-12 10:03:20.20,136
1.0481833,2143270,2115565,3671,18225,2020-09-13 11:05:39.390,358,22175,27705,2093390,260,2020-09-13 00:00:00.000,00:00,2020-09-13 11:05:39.39,121
1.0493867,2151002,2123526,3592,18488,2020-09-14 09:54:40.400,363,22284,27476,2101242,261,2020-09-14 00:00:00.000,00:00,2020-09-14 9:54:40.40,109
1.0475991,2164578,2137268,3433,18877,2020-09-15 09:48:42.420,367,22390,27310,2114878,262,2020-09-15 00:00:00.000,00:00,2020-09-15 9:48:42.42,106
1.0451976,2178832,2152990,3146,19309,2020-09-16 09:37:11.110,367,22503,25842,2130487,263,2020-09-16 00:00:00.000,00:00,2020-09-16 9:37:11.11,113
1.045798,2191892,2166384,2827,19542,2020-09-17 10:09:17.170,372,22656,25508,2143728,264,2020-09-17 00:00:00.000,00:00,2020-09-17 10:09:17.17,153
1.0445849,2206365,2180962,2742,19770,2020-09-18 09:58:10.100,377,22782,25403,2158180,265,2020-09-18 00:00:00.000,00:00,2020-09-18 9:58:10.10,126
1.0431738,2219162,2194457,2635,19969,2020-09-19 10:09:16.160,378,22892,24705,2171565,266,2020-09-19 00:00:00.000,00:00,2020-09-19 10:09:16.16,110
1.0431219,2226701,2202427,2545,20157,2020-09-20 09:52:54.540,383,22974,24274,2179453,267,2020-09-20 00:00:00.000,00:00,2020-09-20 9:52:54.54,82
1.043162,2231589,2209053,2434,20247,2020-09-21 10:01:43.430,385,23044,22536,2186009,268,2020-09-21 00:00:00.000,00:00,2020-09-21 10:01:43.43,70
1.0398805,2245112,2221890,2412,20440,2020-09-22 10:08:48.480,388,23105,23222,2198785,269,2020-09-22 00:00:00.000,00:00,2020-09-22 10:08:48.48,61
1.0380652,2256899,2236372,2277,20649,2020-09-23 10:11:00.000,388,23215,20527,2213157,270,2020-09-23 00:00:00.000,00:00,2020-09-23 10:11:00.00,110
1.038156,2268999,2248217,2178,20831,2020-09-24 10:06:22.220,393,23340,20782,2224877,271,2020-09-24 00:00:00.000,00:00,2020-09-24 10:06:22.22,125
1.0374658,2280276,2260701,2116,20977,2020-09-25 09:56:14.140,395,23454,19575,2237247,272,2020-09-25 00:00:00.000,00:00,2020-09-25 9:56:14.14,114
1.0350654,2290345,2271837,2082,21165,2020-09-26 10:01:53.530,399,23515,18508,2248322,273,2020-09-26 00:00:00.000,00:00,2020-09-26 10:01:53.53,61
1.0365998,2296517,2277639,1951,21247,2020-09-27 10:12:36.360,401,23610,18878,2254029,274,2020-09-27 00:00:00.000,00:00,2020-09-27 10:12:36.36,95
1.0364846,2301303,2282716,1962,21291,2020-09-28 10:25:15.150,406,23660,18587,2259056,275,2020-09-28 00:00:00.000,00:00,2020-09-28 10:25:15.15,50
1.0334986,2313044,2292988,1963,21469,2020-09-29 09:40:17.170,407,23698,20056,2269290,276,2020-09-29 00:00:00.000,00:00,2020-09-29 9:40:17.17,38
1.0341804,2322999,2302403,1822,21590,2020-09-30 09:32:00.000,413,23811,20596,2278592,277,2020-09-30 00:00:00.000,00:00,2020-09-30 9:32:00.00,113
1.0348266,2328435,2308406,1808,21665,2020-10-01 09:38:23.230,415,23888,20029,2284518,278,2020-10-01 00:00:00.000,00:00,2020-10-01 9:38:23.23,77
1.035145,2333777,2313782,1808,21732,2020-10-02 09:51:41.410,416,23951,19995,2289831,279,2020-10-02 00:00:00.000,00:00,2020-10-02 9:51:41.41,63
1.0362413,2339859,2318572,1803,21786,2020-10-03 09:49:46.460,420,24026,21287,2294546,280,2020-10-03 00:00:00.000,00:00,2020-10-03 9:49:46.46,75
1.0364728,2346345,2324229,1820,21844,2020-10-04 09:35:30.300,421,24090,22116,2300139,281,2020-10-04 00:00:00.000,00:00,2020-10-04 9:35:30.30,64
1.0370693,2352378,2329931,1825,21885,2020-10-05 09:32:34.340,422,24163,22447,2305768,282,2020-10-05 00:00:00.000,00:00,2020-10-05 9:32:34.34,73
1.0346199,2365433,2342696,1856,22082,2020-10-06 09:39:51.510,422,24238,22737,2318458,283,2020-10-06 00:00:00.000,00:00,2020-10-06 9:39:51.51,75
1.0336448,2378073,2355935,1734,22333,2020-10-07 09:42:44.440,425,24352,22138,2331583,284,2020-10-07 00:00:00.000,00:00,2020-10-07 9:42:44.44,114
1.0313506,2388844,2367866,1594,22462,2020-10-08 10:01:48.480,427,24421,20978,2343445,285,2020-10-08 00:00:00.000,00:00,2020-10-08 10:01:48.48,69
1.0285628,2400233,2379534,1532,22568,2020-10-09 09:37:05.050,428,24475,20699,2355059,286,2020-10-09 00:00:00.000,00:00,2020-10-09 9:37:05.05,54
1.0289215,2404684,2385702,1479,22623,2020-10-10 09:39:43.430,430,24547,18982,2361155,287,2020-10-10 00:00:00.000,00:00,2020-10-10 9:39:43.43,72
1.0289899,2410483,2391180,1494,22692,2020-10-11 09:32:37.370,432,24605,19303,2366575,288,2020-10-11 00:00:00.000,00:00,2020-10-11 9:32:37.37,58
1.0308301,2415610,2396418,1481,22728,2020-10-12 09:41:38.380,433,24703,19192,2371715,289,2020-10-12 00:00:00.000,00:00,2020-10-12 9:41:38.38,98
1.0298313,2428771,2408647,1542,22863,2020-10-13 09:40:11.110,434,24805,20124,2383842,290,2020-10-13 00:00:00.000,00:00,2020-10-13 9:40:11.11,102
1.0267237,2441443,2423047,1508,23030,2020-10-14 09:35:05.050,438,24878,18396,2398169,291,2020-10-14 00:00:00.000,00:00,2020-10-14 9:35:05.05,73
1.0272657,2450739,2432477,1410,23082,2020-10-15 09:39:51.510,439,24988,18262,2407489,292,2020-10-15 00:00:00.000,00:00,2020-10-15 9:39:51.51,110
1.0251545,2459426,2442071,1467,23180,2020-10-16 09:34:40.400,441,25035,17355,2417036,293,2020-10-16 00:00:00.000,00:00,2020-10-16 9:34:40.40,47
1.0243108,2468527,2451209,1414,23258,2020-10-17 09:49:12.120,443,25108,17318,2426101,294,2020-10-17 00:00:00.000,00:00,2020-10-17 9:49:12.12,73
1.0257056,2474529,2456748,1407,23312,2020-10-18 09:33:56.560,444,25199,17781,2431549,295,2020-10-18 00:00:00.000,00:00,2020-10-18 9:33:56.56,91
1.0264114,2479226,2462463,1443,23368,2020-10-19 09:42:36.360,444,25275,16763,2437188,296,2020-10-19 00:00:00.000,00:00,2020-10-19 9:42:36.36,76
1.0248259,2491311,2471932,1463,23466,2020-10-20 09:32:53.530,447,25333,19379,2446599,297,2020-10-20 00:00:00.000,00:00,2020-10-20 9:32:53.53,58
1.0234317,2503489,2483996,1420,23584,2020-10-21 09:34:27.270,450,25422,19493,2458574,298,2020-10-21 00:00:00.000,00:00,2020-10-21 9:34:27.27,89
1.0235575,2515325,2495512,1388,23647,2020-10-22 09:41:21.210,453,25543,19813,2469969,299,2020-10-22 00:00:00.000,00:00,2020-10-22 9:41:21.21,121
1.0245631,2528621,2508191,1443,23717,2020-10-23 09:37:38.380,455,25698,20430,2482493,300,2020-10-23 00:00:00.000,00:00,2020-10-23 9:37:38.38,155
1.0233084,2540679,2518791,1526,23834,2020-10-24 10:28:46.460,457,25775,21888,2493016,301,2020-10-24 00:00:00.000,00:00,2020-10-24 10:28:46.46,77
1.0234252,2546146,2524464,1484,23869,2020-10-25 09:35:32.320,457,25836,21682,2498628,302,2020-10-25 00:00:00.000,00:00,2020-10-25 9:35:32.32,61
1.0252811,2552264,2531501,1510,23905,2020-10-26 09:38:41.410,457,25955,20763,2505546,303,2020-10-26 00:00:00.000,00:00,2020-10-26 9:38:41.41,119
1.0234679,2567587,2544584,1593,23981,2020-10-27 09:38:15.150,460,26043,23003,2518541,304,2020-10-27 00:00:00.000,00:00,2020-10-27 9:38:15.15,88
1.0213058,2582960,2560056,1602,24073,2020-10-28 09:35:23.230,461,26146,22904,2533910,305,2020-10-28 00:00:00.000,00:00,2020-10-28 9:35:23.23,103
1.0214906,2597978,2571830,1612,24168,2020-10-29 09:37:57.570,462,26271,26148,2545559,306,2020-10-29 00:00:00.000,00:00,2020-10-29 9:37:57.57,125
1.020319,2612231,2585858,1641,24227,2020-10-30 09:31:55.550,463,26384,26373,2559474,307,2020-10-30 00:00:00.000,00:00,2020-10-30 9:31:55.55,113
1.0201192,2624492,2598814,1694,24311,2020-10-31 09:35:23.230,464,26511,25678,2572303,308,2020-10-31 00:00:00.000,00:00,2020-10-31 9:35:23.23,127
1.0221461,2630630,2605792,1736,24357,2020-11-01 09:41:40.400,466,26635,24838,2579157,309,2020-11-01 00:00:00.000,00:00,2020-11-01 9:41:40.40,124
1.0237728,2636650,2611126,1812,24395,2020-11-02 09:35:10.100,468,26732,25524,2584394,310,2020-11-02 00:00:00.000,00:00,2020-11-02 9:35:10.10,97
1.0215911,2649859,2624044,1869,24510,2020-11-03 09:30:37.370,472,26807,25815,2597237,311,2020-11-03 00:00:00.000,00:00,2020-11-03 9:30:37.37,75
1.0206198,2662260,2638005,1825,24616,2020-11-04 09:37:25.250,474,26924,24255,2611081,312,2020-11-04 00:00:00.000,00:00,2020-11-04 9:37:25.25,117
1.0212399,2673705,2648643,1839,24735,2020-11-05 09:51:34.898,475,27049,25062,2621594,313,2020-11-05 00:00:00.000,00:00,2021-04-27 10:21:26.657,125
1.022068,2686313,2660684,1897,24821,2020-11-06 09:24:23.717,476,27194,25629,2633490,314,2020-11-06 00:00:00.000,00:00,2021-04-27 10:21:41.298,145
1.0214407,2697248,2671031,1896,24910,2020-11-07 09:40:32.259,477,27283,26217,2643748,315,2020-11-07 00:00:00.000,00:00,2021-04-27 10:22:14.706,89
1.0244167,2702879,2677231,1980,24968,2020-11-08 09:34:44.609,478,27426,25648,2649805,316,2020-11-08 00:00:00.000,00:00,2021-04-27 10:22:43.403,143
1.0267587,2709198,2683396,2043,25029,2020-11-09 09:36:39.787,480,27552,25802,2655844,317,2020-11-09 00:00:00.000,00:00,2021-04-27 10:23:00.104,126
1.0256281,2723959,2696104,2007,25160,2020-11-10 09:37:02.955,485,27652,27855,2668452,318,2020-11-10 00:00:00.000,00:00,2021-04-27 10:23:19.579,100
1.0265362,2736532,2707844,2044,25266,2020-11-11 09:35:35.369,487,27797,28688,2680047,319,2020-11-11 00:00:00.000,00:00,2021-04-27 10:23:36.333,145
1.0270224,2749770,2720486,2049,25404,2020-11-12 09:39:23.831,487,27940,29284,2692546,320,2020-11-12 00:00:00.000,00:00,2021-04-27 10:23:55.542,143
1.0299529,2761409,2731290,2106,25537,2020-11-13 09:35:49.753,488,28131,30119,2703159,321,2020-11-13 00:00:00.000,00:00,2021-04-27 10:24:23.651,191
1.033182,2777287,2742595,2208,25636,2020-11-14 09:31:38.207,492,28336,34692,2714259,322,2020-11-14 00:00:00.000,00:00,2021-04-27 10:24:41.625,205
1.0377758,2786876,2750498,2360,25691,2020-11-15 09:40:16.172,493,28544,36378,2721954,323,2020-11-15 00:00:00.000,00:00,2021-04-27 10:24:58.539,208
1.0424829,2797688,2759374,2513,25759,2020-11-16 09:34:22.212,494,28766,38314,2730608,324,2020-11-16 00:00:00.000,00:00,2021-04-27 10:25:15.916,222
1.04507,2815753,2774551,2642,25860,2020-11-17 09:38:28.585,494,28996,41202,2745555,325,2020-11-17 00:00:00.000,00:00,2021-04-27 10:25:35.527,230
1.0488801,2834332,2791644,2812,25973,2020-11-18 09:34:00.934,496,29281,42688,2762363,326,2020-11-18 00:00:00.000,00:00,2021-04-27 10:25:56.576,285
1.0542433,2853795,2808270,3010,26098,2020-11-19 09:32:40.671,498,29606,45525,2778664,327,2020-11-19 00:00:00.000,00:00,2021-04-27 10:26:13.038,325
1.0602297,2873380,2825237,3190,26263,2020-11-20 09:35:51.078,501,29954,48143,2795283,328,2020-11-20 00:00:00.000,00:00,2021-04-27 10:26:29.992,348
1.0663056,2896683,2845338,3472,26365,2020-11-21 09:35:35.158,503,30340,51345,2814998,329,2020-11-21 00:00:00.000,00:00,2021-04-27 10:26:57.143,386
1.0743318,2908827,2854798,3699,26466,2020-11-22 09:35:12.388,505,30670,54029,2824128,330,2020-11-22 00:00:00.000,00:00,2021-04-27 10:51:26.4,330
1.0797325,2922072,2865617,3893,26539,2020-11-23 09:33:24.973,509,30941,56455,2834676,331,2020-11-23 00:00:00.000,00:00,2021-04-27 10:51:48.849,271
1.0832361,2946336,2888567,4058,26722,2020-11-24 09:33:23.193,510,31290,57769,2857277,332,2020-11-24 00:00:00.000,00:00,2021-04-27 10:52:54.528,349
1.0881964,2966342,2910504,4334,26825,2020-11-25 09:32:47.722,513,31672,55838,2878832,333,2020-11-25 00:00:00.000,00:00,2021-04-27 10:53:29.69,382
1.0998012,2987982,2932621,4788,26950,2020-11-26 09:44:15.678,515,32253,55361,2900368,334,2020-11-26 00:00:00.000,00:00,2021-04-27 10:54:04.101,581
1.1110576,3009499,2952862,5189,27103,2020-11-27 09:39:01.652,516,32808,56637,2920054,335,2020-11-27 00:00:00.000,00:00,2021-04-20 16:57:15.303,555
1.1203957,3031940,2973146,5440,27349,2020-11-28 09:31:45.871,522,33311,58794,2939835,336,2020-11-28 00:00:00.000,00:00,2021-04-20 16:56:43.564,503
1.1313709,3046908,2984079,5696,27542,2020-11-29 09:33:56.021,523,33761,62829,2950318,337,2020-11-29 00:00:00.000,00:00,2021-04-20 16:56:17.367,450
1.1408013,3061170,2997805,6048,27625,2020-11-30 14:29:16.143,526,34199,63365,2963606,338,2020-11-30 00:00:00.000,00:00,2021-04-20 16:55:54.849,438
1.1476918,3083995,3019103,6239,27885,2020-12-01 09:36:29.450,526,34650,64892,2984453,339,2020-12-01 00:00:00.000,00:00,2021-04-20 16:39:24.094,451
1.155922,3106968,3041814,6570,28065,2020-12-02 09:35:32.913,526,35161,65154,3006653,340,2020-12-02 00:00:00.000,00:00,2021-04-20 16:39:02.139,511
1.1643797,3131884,3066096,6820,28352,2020-12-03 09:49:33.754,529,35701,65788,3030395,341,2020-12-03 00:00:00.000,00:00,2021-04-20 16:38:46.863,540
1.1744074,3157407,3093390,7182,28611,2020-12-04 09:44:32.682,536,36329,64017,3057061,342,2020-12-04 00:00:00.000,00:00,2021-04-20 16:38:22.828,628
1.18508,3180487,3114220,7449,28917,2020-12-05 10:15:39.581,540,36906,66267,3077314,343,2020-12-05 00:00:00.000,00:00,2021-04-20 16:38:08.438,577
1.2003613,3194858,3127142,7864,29128,2020-12-06 09:48:54.801,545,37537,67716,3089605,344,2020-12-06 00:00:00.000,00:00,2021-04-20 16:37:48.464,631
1.214507,3209367,3141357,8302,29301,2020-12-07 09:30:10.758,549,38152,68010,3103205,345,2020-12-07 00:00:00.000,00:00,2021-04-20 16:33:40.675,615
1.2341536,3221449,3150175,8676,29650,2020-12-09 11:28:44.404,552,38878,71274,3111297,348,2020-12-08 00:00:00.000,00:00,2021-04-20 16:22:39.718,726
1.2400048,3253213,3178133,8676,30177,2020-12-09 09:44:25.831,556,39409,75080,3138724,347,2020-12-09 00:00:00.000,00:00,2021-04-20 16:22:58.083,531
1.2507589,3277938,3205174,8888,30637,2020-12-10 09:27:13.236,564,40089,72764,3165085,349,2020-12-10 00:00:00.000,00:00,2021-04-20 16:22:19.281,680
1.2611036,3311205,3233517,9049,31157,2020-12-11 09:33:06.394,572,40778,77688,3192739,350,2020-12-11 00:00:00.000,00:00,2021-04-20 16:21:59.021,689
1.2787784,3349856,3263114,9657,31493,2020-12-12 09:19:01.382,578,41728,86742,3221386,351,2020-12-12 00:00:00.000,00:00,2021-04-20 16:21:45.633,950
1.3018281,3374585,3284458,10364,31814,2020-12-13 09:48:21.971,580,42758,90127,3241700,352,2020-12-13 00:00:00.000,00:00,2021-04-20 16:21:31.52,1030
1.3143543,3397031,3307784,10787,32102,2020-12-14 09:38:10.035,587,43476,89247,3264308,353,2020-12-14 00:00:00.000,00:00,2021-04-20 16:21:14.357,718
1.3249539,3441212,3347739,11197,32559,2020-12-15 09:34:38.398,600,44356,93473,3303383,354,2020-12-15 00:00:00.000,00:00,2021-04-20 16:20:56.074,880
1.3386655,3488761,3393977,11875,32947,2020-12-16 09:37:53.572,612,45434,94784,3348543,355,2020-12-16 00:00:00.000,00:00,2021-04-20 16:20:24.018,1078
1.3503987,3538835,3439577,12204,33610,2020-12-17 09:34:22.890,634,46448,99258,3393129,356,2020-12-17 00:00:00.000,00:00,2021-04-20 16:19:52.745,1014
1.3656114,3589792,3479174,12885,33982,2020-12-19 09:39:06.640,645,47512,110618,3431662,358,2020-12-18 00:00:00.000,00:00,2021-04-20 16:19:30.473,1064
1.3794595,3646235,3520002,13564,34334,2020-12-19 10:32:55.469,659,48557,126233,3471445,359,2020-12-19 00:00:00.000,00:00,2021-04-20 16:19:11.693,1045
1.4012272,3683083,3543608,14258,34722,2020-12-20 09:32:54.292,674,49654,139475,3493954,360,2020-12-20 00:00:00.000,00:00,2021-04-20 16:17:30.074,1097
1.4177788,3713849,3567411,14725,35155,2020-12-21 09:35:07.787,698,50578,146438,3516833,361,2020-12-21 00:00:00.000,00:00,2021-04-20 16:17:03.272,924
1.4205999,3772416,3621287,14794,35928,2020-12-22 09:35:08.235,722,51444,151129,3569843,362,2020-12-22 00:00:00.000,00:00,2021-04-20 16:16:42.465,866
1.4301009,3826556,3673447,15069,36726,2020-12-23 09:35:51.755,739,52534,153109,3620913,363,2020-12-23 00:00:00.000,00:00,2021-04-20 16:16:22.083,1090
1.4341863,3882196,3731663,15338,37425,2020-12-24 09:37:42.339,756,53519,150533,3678144,364,2020-12-24 00:00:00.000,00:00,2021-04-20 16:15:55.356,985
1.4476715,3939346,3782557,15938,38048,2020-12-25 09:19:59.409,773,54759,156789,3727798,365,2020-12-25 00:00:00.000,00:00,2021-04-20 16:15:34.566,1240
1.4660091,3969403,3812391,16565,38532,2020-12-26 09:35:23.058,793,55890,157012,3756501,366,2020-12-26 00:00:00.000,00:00,2021-04-20 16:15:05.02,1131
1.4809513,4006400,3839424,17012,39040,2020-12-27 09:32:40.326,808,56860,166976,3782564,367,2020-12-27 00:00:00.000,00:00,2021-04-20 16:14:27.518,970
1.4906876,4038294,3868416,17579,39268,2020-12-28 09:40:11.190,819,57666,169878,3810750,368,2020-12-28 00:00:00.000,00:00,2021-04-20 16:14:02.198,806
1.4949567,4098166,3927204,17148,40703,2020-12-29 09:37:33.024,859,58710,170962,3868494,369,2020-12-29 00:00:00.000,00:00,2021-04-20 16:13:28.79,1044
1.4985939,4159509,3987738,17446,41435,2020-12-30 09:35:46.266,879,59760,171771,3927978,370,2020-12-30 00:00:00.000,00:00,2021-04-20 16:13:02.935,1050
1.5018317,4213867,4043529,17557,42270,2020-12-31 09:35:07.493,900,60727,170338,3982802,371,2020-12-31 00:00:00.000,00:00,2021-04-20 16:12:20.079,967
1.5090011,4269303,4092376,17884,42953,2021-01-01 09:36:53.691,917,61754,176927,4030622,372,2021-01-01 00:00:00.000,00:00,2021-04-20 16:11:34.691,1027
1.5175366,4302780,4123393,18054,43578,2021-01-02 09:34:52.775,942,62574,179387,4060819,373,2021-01-02 00:00:00.000,00:00,2021-04-20 16:11:00.677,820
1.522042,4340825,4154353,17762,44507,2021-01-03 09:31:48.677,962,63231,186472,4091122,374,2021-01-03 00:00:00.000,00:00,2021-04-20 16:10:23.954,657
1.5349523,4376595,4185863,18030,45240,2021-01-04 09:33:08.918,981,64251,190732,4121612,375,2021-01-04 00:00:00.000,00:00,2021-04-20 16:05:38.401,1020
1.5301739,4439347,4245596,17786,46172,2021-01-05 09:35:18.724,1007,64965,193751,4180631,376,2021-01-05 00:00:00.000,00:00,2021-04-20 15:45:18.126,714
1.5257708,4504853,4312771,17781,46995,2021-01-06 09:35:00.362,1027,65803,192082,4246968,377,2021-01-06 00:00:00.000,00:00,2021-04-20 15:44:50.929,838
1.5228753,4569796,4378034,17977,47649,2021-01-07 09:38:10.203,1046,66672,191762,4311362,378,2021-01-07 00:00:00.000,00:00,2021-04-20 15:44:25.071,869
1.516959,4629992,4439540,17896,48369,2021-01-08 09:37:55.083,1081,67346,190452,4372194,379,2021-01-08 00:00:00.000,00:00,2021-04-20 15:43:08.95,674
1.5095874,4689604,4503681,17563,49324,2021-01-09 09:41:10.876,1100,67987,185923,4435694,380,2021-01-09 00:00:00.000,00:00,2021-04-20 15:42:29.76,641
1.5146548,4723444,4531990,17110,50409,2021-01-10 09:25:25.617,1125,68644,191454,4463346,381,2021-01-10 00:00:00.000,00:00,2021-04-20 15:41:04.466,657
1.5146091,4751666,4561903,15403,52552,2021-01-11 09:40:23.425,1140,69095,189763,4492808,382,2021-01-11 00:00:00.000,00:00,2021-04-20 15:39:52.844,451
1.5048094,4814067,4627297,14898,53569,2021-01-12 09:36:03.299,1165,69632,186770,4557665,383,2021-01-12 00:00:00.000,00:00,2021-04-20 15:33:29.579,537
1.4968481,4872301,4689387,14372,54636,2021-01-13 09:37:24.087,1185,70193,182914,4619194,384,2021-01-13 00:00:00.000,00:00,2021-04-20 15:31:52.134,561
1.487024,4925348,4755606,13750,55772,2021-01-14 09:35:43.906,1195,70717,169742,4684889,385,2021-01-14 00:00:00.000,00:00,2021-04-20 15:31:27.298,524
1.4790874,4978063,4815740,13476,56536,2021-01-15 09:39:30.220,1217,71229,162323,4744511,386,2021-01-15 00:00:00.000,00:00,2021-04-20 15:29:31.24,512
1.4725158,5032259,4876620,13019,57554,2021-01-16 09:49:04.497,1236,71809,155639,4804811,387,2021-01-16 00:00:00.000,00:00,2021-04-20 15:25:25.124,580
1.4755317,5061279,4901894,12827,58253,2021-01-17 15:27:58.692,1249,72329,159385,4829565,487,2021-01-17 00:00:00.000,00:00,2021-04-20 15:29:06.35,520
1.4752573,5087209,4929174,12731,58723,2021-01-18 09:38:38.427,1264,72718,158035,4856456,390,2021-01-18 00:00:00.000,00:00,2021-04-20 15:23:48.267,389
1.4661942,5140315,4985970,12353,59468,2021-01-19 09:39:49.588,1283,73104,154345,4912866,391,2021-01-19 00:00:00.000,00:00,2021-04-20 15:23:34.538,386
1.4573418,5192119,5043978,12028,60180,2021-01-20 09:38:16.549,1300,73508,148141,4970470,392,2021-01-20 00:00:00.000,00:00,2021-04-20 15:23:25.562,404
1.4501637,5237598,5096528,11746,60846,2021-01-21 09:39:24.111,1316,73908,141070,5022620,393,2021-01-21 00:00:00.000,00:00,2021-04-20 15:23:10.249,400
1.4420817,5282216,5149084,11511,61415,2021-01-22 09:36:14.355,1328,74254,133132,5074830,394,2021-01-22 00:00:00.000,00:00,2021-04-20 15:22:54.173,346
1.4381664,5329700,5193071,11304,62044,2021-01-23 09:40:55.809,1337,74685,136629,5118386,395,2021-01-23 00:00:00.000,00:00,2021-04-20 15:22:39.689,431
1.4386489,5354342,5218577,11198,62530,2021-01-24 09:31:28.637,1349,75077,135765,5143500,396,2021-01-24 00:00:00.000,00:00,2021-04-20 15:22:11.021,392
1.4406862,5376079,5241530,11198,62956,2021-01-25 09:38:09.015,1360,75514,134549,5166016,397,2021-01-25 00:00:00.000,00:00,2021-04-20 15:21:00.814,437
1.4356743,5422761,5284137,9699,64793,2021-01-26 09:41:15.083,1371,75863,138624,5208274,398,2021-01-26 00:00:00.000,00:00,2021-04-20 15:20:41.089,349
1.4335899,5469240,5330813,9566,65478,2021-01-27 09:45:38.773,1378,76422,138427,5254391,399,2021-01-27 00:00:00.000,00:00,2021-04-20 15:20:05.793,559
1.4289886,5522182,5382758,9517,66016,2021-01-28 09:38:09.595,1386,76919,139424,5305839,400,2021-01-28 00:00:00.000,00:00,2021-04-20 15:18:38.789,497
1.4261116,5569257,5426504,9486,66503,2021-01-29 09:37:53.565,1399,77388,142753,5349116,401,2021-01-29 00:00:00.000,00:00,2021-04-20 15:14:02.565,469
1.4229182,5616524,5470729,9309,67121,2021-01-30 09:30:22.952,1414,77844,145795,5392885,402,2021-01-30 00:00:00.000,00:00,2021-04-20 15:13:24.688,456
1.424044,5640813,5491263,8900,67878,2021-01-31 09:32:09.004,1420,78198,149550,5413065,403,2021-01-31 00:00:00.000,00:00,2021-04-20 15:13:00.048,354
1.4241215,5661837,5512381,8769,68309,2021-02-01 10:15:01.974,1425,78503,149456,5433878,404,2021-02-01 00:00:00.000,00:00,2021-04-20 15:10:54.481,305
1.4186966,5711408,5557143,8629,68775,2021-02-02 09:36:54.134,1435,78839,154265,5478304,405,2021-02-02 00:00:00.000,00:00,2021-04-20 15:10:31.272,336
1.4116763,5756709,5617860,8566,69299,2021-02-03 09:31:25.637,1441,79306,138849,5538554,407,2021-02-03 00:00:00.000,00:00,2021-04-20 15:10:07.359,467
1.4035419,5803090,5682552,8605,69704,2021-02-04 09:37:28.112,1448,79757,120538,5602795,408,2021-02-04 00:00:00.000,00:00,2021-04-20 15:09:41.835,451
1.3960096,5847174,5739717,8551,70117,2021-02-05 09:33:36.664,1459,80127,107457,5659590,409,2021-02-05 00:00:00.000,00:00,2021-04-20 15:09:07.568,370
1.3892615,5893346,5795669,8548,70505,2021-02-06 09:32:30.765,1464,80517,97677,5715152,410,2021-02-06 00:00:00.000,00:00,2021-04-20 15:08:52.281,390
1.3883454,5916967,5826216,8552,70865,2021-02-07 09:36:08.210,1471,80888,90751,5745328,411,2021-02-07 00:00:00.000,00:00,2021-04-20 15:08:37.504,371
1.3868309,5938188,5853345,8484,71218,2021-02-08 09:33:37.055,1474,81176,84843,5772169,412,2021-02-08 00:00:00.000,00:00,2021-04-20 15:08:09.97,288
1.3798848,5987398,5904768,8321,71676,2021-02-09 09:31:54.660,1482,81479,82630,5823289,413,2021-02-09 00:00:00.000,00:00,2021-04-20 15:07:54.649,303
1.376871,6030016,5949940,8211,72226,2021-02-10 09:33:33.861,1486,81923,80076,5868017,414,2021-02-10 00:00:00.000,00:00,2021-04-20 15:07:26.082,444
1.3764474,6070001,5988387,8293,72638,2021-02-11 09:31:14.234,1496,82427,81614,5905960,415,2021-02-11 00:00:00.000,00:00,2021-04-20 15:07:13.616,504
1.3776298,6093362,6012501,8387,72936,2021-02-12 09:31:24.356,1507,82830,80861,5929671,416,2021-02-12 00:00:00.000,00:00,2021-04-20 15:06:55.687,403
1.3761938,6115330,6045079,8451,73227,2021-02-13 10:09:06.162,1514,83192,70251,5961887,417,2021-02-13 00:00:00.000,00:00,2021-04-20 15:06:34.597,362
1.3777577,6140079,6061879,8437,73559,2021-02-14 09:31:30.401,1522,83518,78200,5978361,418,2021-02-14 00:00:00.000,00:00,2021-04-20 15:06:15.982,326
1.3786792,6162852,6082706,8540,73794,2021-02-15 09:32:45.168,1527,83861,80146,5998845,419,2021-02-15 00:00:00.000,00:00,2021-04-20 15:05:50.141,343
1.3740213,6213483,6136586,8233,74551,2021-02-16 09:31:34.953,1534,84318,76897,6052268,420,2021-02-16 00:00:00.000,00:00,2021-04-20 15:05:32.332,457
1.3726074,6260560,6188150,8041,75360,2021-02-17 09:36:02.951,1538,84939,72410,6103211,421,2021-02-17 00:00:00.000,00:00,2021-04-20 15:04:59.421,621
1.3728067,6303207,6232487,8120,75896,2021-02-18 09:31:33.593,1544,85560,70720,6146927,422,2021-02-18 00:00:00.000,00:00,2021-04-20 15:04:44.372,621
1.3724749,6345985,6274869,8058,76513,2021-02-19 09:33:30.840,1550,86121,71116,6188748,423,2021-02-19 00:00:00.000,00:00,2021-04-20 15:04:31.604,561
1.3709742,6390625,6314488,7934,77083,2021-02-20 09:40:36.883,1553,86570,76137,6227918,425,2021-02-20 00:00:00.000,00:00,2021-04-20 15:04:09.208,449
1.372441,6411333,6337977,7912,77516,2021-02-21 09:34:28.285,1557,86985,73356,6250992,426,2021-02-21 00:00:00.000,00:00,2021-04-20 15:03:53.739,415
1.3736267,6429137,6356676,7868,77887,2021-02-22 09:30:56.472,1562,87317,72461,6269359,427,2021-02-22 00:00:00.000,00:00,2021-04-20 15:03:38.219,332
1.3701891,6472671,6398606,7706,78394,2021-02-23 09:31:45.903,1573,87673,74065,6310933,428,2021-02-23 00:00:00.000,00:00,2021-04-20 15:03:16.321,356
1.3690661,6510981,6435993,7487,79050,2021-02-24 09:33:42.127,1576,88113,74988,6347880,429,2021-02-24 00:00:00.000,00:00,2021-04-20 15:02:56.51,440
1.3653303,6551206,6482534,7440,79487,2021-02-25 09:31:53.266,1581,88508,68672,6394026,430,2021-02-25 00:00:00.000,00:00,2021-04-20 15:02:37.668,395
1.3631903,6590042,6521100,7430,79880,2021-02-26 09:32:51.735,1585,88895,68942,6432205,431,2021-02-26 00:00:00.000,00:00,2021-04-20 15:02:19.005,387
1.3618028,6627207,6558218,7382,80333,2021-02-27 09:37:27.179,1595,89310,68989,6468908,433,2021-02-27 00:00:00.000,00:00,2021-04-20 14:59:32.479,415
1.3634967,6648996,6576107,7365,80697,2021-02-28 10:24:54.713,1603,89665,72889,6486442,434,2021-02-28 00:00:00.000,00:00,2021-04-20 14:59:08.938,355
1.3655943,6665747,6592002,7345,81070,2021-03-01 09:48:21.402,1605,90020,73745,6501982,435,2021-03-01 00:00:00.000,00:00,2021-04-20 14:58:56.038,355
1.3673829,6681969,6608537,7420,81338,2021-03-02 09:32:41.950,1606,90364,73432,6518173,436,2021-03-02 00:00:00.000,00:00,2021-04-20 14:57:59.417,344
1.3654662,6716196,6650329,7496,81700,2021-03-03 09:33:02.813,1612,90808,65867,6559521,437,2021-03-03 00:00:00.000,00:00,2021-04-20 14:57:38.163,444
1.3633394,6751893,6691804,7451,82162,2021-03-04 09:33:23.999,1619,91232,60089,6600572,438,2021-03-04 00:00:00.000,00:00,2021-04-20 14:57:22.272,424
1.3624678,6789004,6725297,7443,82560,2021-03-05 09:41:54.920,1627,91630,63707,6633667,439,2021-03-05 00:00:00.000,00:00,2021-04-20 14:57:05.073,398
1.3623087,6821936,6756765,7503,82913,2021-03-06 09:40:17.621,1632,92048,65171,6664717,440,2021-03-06 00:00:00.000,00:00,2021-04-20 14:56:41.076,418
1.3644353,6843119,6776723,7610,83220,2021-03-07 09:52:34.246,1634,92464,66396,6684259,441,2021-03-07 00:00:00.000,00:00,2021-04-20 14:51:55.518,416
1.3659762,6861802,6794408,7694,83474,2021-03-08 09:31:46.646,1642,92810,67394,6701598,442,2021-03-08 00:00:00.000,00:00,2021-04-20 14:51:41.422,346
1.3648932,6902977,6832476,7711,83900,2021-03-09 09:52:46.909,1645,93256,70501,6739220,443,2021-03-09 00:00:00.000,00:00,2021-04-20 14:51:28.616,446
1.3645577,6938877,6868599,7766,84312,2021-03-10 09:45:29.181,1648,93726,70278,6774873,444,2021-03-10 00:00:00.000,00:00,2021-04-20 14:50:56.417,470
1.363362,6976978,6908730,7864,84675,2021-03-11 09:39:02.159,1652,94191,68248,6814539,445,2021-03-11 00:00:00.000,00:00,2021-04-20 14:48:58.191,465
1.3634808,7012657,6943919,7274,85743,2021-03-12 09:49:58.077,1662,94679,68738,6849240,446,2021-03-12 00:00:00.000,00:00,2021-04-20 14:48:36.524,488
1.3636675,7046775,6978901,6877,86625,2021-03-13 09:36:41.886,1667,95169,67874,6883732,447,2021-03-13 00:00:00.000,00:00,2021-04-20 14:48:06.227,490
1.3667877,7066394,6996551,6551,87408,2021-03-14 09:42:57.640,1669,95628,69843,6900923,448,2021-03-14 00:00:00.000,00:00,2021-04-20 14:47:44.94,459
1.3689198,7084930,7013340,6578,87754,2021-03-15 09:51:09.370,1675,96007,71590,6917333,449,2021-03-15 00:00:00.000,00:00,2021-04-20 14:47:28.958,379
1.3673338,7126067,7048023,6437,88255,2021-03-16 09:36:13.502,1678,96370,78044,6951653,450,2021-03-16 00:00:00.000,00:00,2021-04-20 14:46:59.298,363
1.3662314,7171500,7088038,6339,88814,2021-03-17 09:31:37.789,1686,96839,83462,6991199,451,2021-03-17 00:00:00.000,00:00,2021-04-20 14:46:39.82,469
1.3647468,7218077,7128355,6418,89178,2021-03-18 09:38:40.962,1688,97284,89722,7031071,452,2021-03-18 00:00:00.000,00:00,2021-04-20 14:46:21.32,445
1.3620257,7264931,7176590,6534,89523,2021-03-19 09:32:03.884,1690,97747,88341,7078843,453,2021-03-19 00:00:00.000,00:00,2021-04-20 14:45:53.021,463
1.3607973,7308935,7215917,6552,89949,2021-03-20 09:31:53.146,1693,98194,93018,7117723,454,2021-03-20 00:00:00.000,00:00,2021-04-20 14:45:35.163,447
1.3636255,7332699,7234391,6626,90328,2021-03-21 09:53:34.815,1696,98650,98308,7135741,455,2021-03-21 00:00:00.000,00:00,2021-04-20 14:45:11.413,456
1.3658822,7355954,7252822,6757,90611,2021-03-22 10:04:58.004,1697,99065,103132,7153757,456,2021-03-22 00:00:00.000,00:00,2021-04-20 14:44:34.623,415
1.3616438,7400980,7300808,6628,91079,2021-03-23 09:32:10.986,1704,99411,100172,7201397,457,2021-03-23 00:00:00.000,00:00,2021-04-20 14:44:18.502,346
1.3589312,7441203,7346877,6572,91560,2021-03-24 09:35:12.391,1707,99839,94326,7247038,458,2021-03-24 00:00:00.000,00:00,2021-04-20 14:43:58.157,428
1.3551936,7485852,7398869,6492,92068,2021-03-25 09:34:48.910,1709,100269,86983,7298600,459,2021-03-25 00:00:00.000,00:00,2021-04-20 14:43:42.787,430
1.3520967,7529391,7451982,6412,92630,2021-03-26 09:33:28.300,1716,100758,77409,7351224,460,2021-03-26 00:00:00.000,00:00,2021-04-20 14:43:22.594,489
1.3506448,7572556,7497382,6067,93475,2021-03-27 09:53:35.032,1721,101263,75174,7396119,461,2021-03-27 00:00:00.000,00:00,2021-04-20 14:42:54.126,505
1.3535358,7595584,7516979,6168,93855,2021-03-28 11:17:23.373,1722,101745,78605,7415234,462,2021-03-28 00:00:00.000,00:00,2021-04-20 14:42:38.562,482
1.3549405,7616317,7537379,6277,94124,2021-03-29 09:41:57.983,1726,102127,78938,7435252,463,2021-03-29 00:00:00.000,00:00,2021-04-20 14:42:25.82,382
1.3522259,7663991,7585567,6282,94563,2021-03-30 09:39:54.626,1729,102574,78424,7482993,465,2021-03-30 00:00:00.000,00:00,2021-04-20 14:42:04.778,447
1.3498348,7707792,7636490,6319,95030,2021-03-31 09:32:59.933,1731,103080,71302,7533410,466,2021-03-31 00:00:00.000,00:00,2021-04-20 14:41:41.712,506
1.3496016,7747295,7678636,6457,95439,2021-04-01 09:32:19.520,1735,103631,68659,7575005,467,2021-04-01 00:00:00.000,00:00,2021-04-20 14:41:23.051,551
1.350016,7788290,7717538,6590,95861,2021-04-02 09:54:00.108,1737,104188,70752,7613350,468,2021-04-02 00:00:00.000,00:00,2021-04-20 14:40:42.759,557
1.3506169,7829596,7754308,6795,96196,2021-04-03 09:34:03.806,1740,104731,75288,7649577,469,2021-04-03 00:00:00.000,00:00,2021-04-20 14:40:25.997,543
1.3549223,7849470,7769671,6940,96589,2021-04-04 09:45:05.147,1744,105273,79799,7664398,470,2021-04-04 00:00:00.000,00:00,2021-04-20 14:40:12.582,542
1.3577642,7868815,7788318,7099,96900,2021-04-05 09:44:27.235,1748,105747,80497,7682571,471,2021-04-05 00:00:00.000,00:00,2021-04-20 14:39:30.302,474
1.3545301,7921284,7842129,7109,97363,2021-04-06 09:31:57.498,1752,106224,79155,7735905,472,2021-04-06 00:00:00.000,00:00,2021-04-20 14:39:01.36,477
1.3545175,7966161,7891519,7208,97928,2021-04-07 09:37:24.979,1756,106892,74642,7784627,473,2021-04-07 00:00:00.000,00:00,2021-04-20 14:38:33.513,668
1.3560158,8012415,7934421,7474,98360,2021-04-08 09:30:58.826,1758,107592,77994,7826829,474,2021-04-08 00:00:00.000,00:00,2021-04-20 14:38:13.56,700
1.3571563,8059107,7977195,7713,98786,2021-04-09 09:33:53.300,1764,108263,81912,7868932,475,2021-04-09 00:00:00.000,00:00,2021-04-20 14:37:51.855,671
1.3589283,8106625,8016611,7874,99301,2021-04-10 09:36:31.907,1765,108940,90014,7907671,476,2021-04-10 00:00:00.000,00:00,2021-04-20 14:37:10.346,677
1.3630158,8129527,8037618,7677,100109,2021-04-11 09:36:07.611,1768,109554,91909,7928064,477,2021-04-11 00:00:00.000,00:00,2021-04-20 14:36:51.706,614
1.3669325,8152778,8057530,7567,100804,2021-04-12 09:36:52.596,1770,110141,95248,7947389,478,2021-04-12 00:00:00.000,00:00,2021-04-20 14:36:31.34,587
1.3639427,8200514,8114930,7576,101332,2021-04-13 09:36:30.661,1775,110683,85584,8004247,479,2021-04-13 00:00:00.000,00:00,2021-04-20 14:36:13.585,542
1.3635703,8245383,8170756,7649,101983,2021-04-14 09:33:58.653,1782,111414,74627,8059342,480,2021-04-14 00:00:00.000,00:00,2021-04-20 14:35:54.244,731
1.3637437,8291121,8220900,7811,102513,2021-04-15 09:38:50.340,1788,112112,70221,8108788,481,2021-04-15 00:00:00.000,00:00,2021-04-20 14:35:43.42,698
1.3650312,8333331,8262448,7933,103062,2021-04-16 09:32:10.738,1790,112785,70883,8149663,482,2021-04-16 00:00:00.000,00:00,2021-04-20 14:35:13.573,673
1.3656743,8377778,8306739,8055,103594,2021-04-17 09:40:16.606,1794,113443,71039,8193296,483,2021-04-17 00:00:00.000,00:00,2021-04-18 09:35:59.415,658
1.370924,8396066,8323875,8311,104006,2021-04-18 09:30:44.979,1797,114114,72191,8209761,484,2021-04-18 00:00:00.000,00:00,2021-04-19 09:39:27.906,671
1.3739837,8414821,8344058,8371,104474,2021-04-19 09:39:21.483,1801,114646,70763,8229412,485,2021-04-19 00:00:00.000,00:00,null,532
1.372676,8458592,8392002,8166,105227,2021-04-20 09:34:02.801,1802,115195,66590,8276807,486,2021-04-20 00:00:00.000,00:00,null,549
1.3750976,8497594,8430383,8243,105877,2021-04-21 09:36:56.675,1806,115926,67211,8314457,488,2021-04-21 00:00:00.000,00:00,null,731
1.377284,8537505,8470366,8394,106459,2021-04-22 09:31:58.246,1808,116661,67139,8353705,489,2021-04-22 00:00:00.000,00:00,null,735
1.3796529,8583530,8513591,8576,107071,2021-04-23 09:51:40.550,1811,117458,69939,8396133,490,2021-04-23 00:00:00.000,00:00,null,797
1.3822067,8632923,8554654,8650,107781,2021-04-24 09:38:23.778,1812,118243,78269,8436411,491,2021-04-24 00:00:00.000,00:00,null,785
1.3860767,8654791,8577231,8599,108475,2021-04-25 09:52:51.000,1813,118887,77560,8458344,492,2021-04-25 00:00:00.000,00:00,null,644
1.389034,8672978,8594894,8719,108850,2021-04-26 09:42:14.750,1817,119386,78084,8475508,493,2021-04-26 00:00:00.000,00:00,2021-04-27 09:37:24.371,499
1.3868896,8721609,8645101,8383,109695,2021-04-27 09:34:47.417,1820,119898,76508,8525203,494,2021-04-27 00:00:00.000,00:00,null,512
1.3886694,8766491,8689325,8597,110248,2021-04-28 09:33:01.863,1821,120666,77166,8568659,495,2021-04-28 00:00:00.000,00:00,2021-04-30 09:39:12.945,768
1.3907242,8805774,8725382,8734,110787,2021-04-29 09:32:46.339,1825,121346,80392,8604036,496,2021-04-29 00:00:00.000,00:00,2021-04-30 09:39:29.337,680
1.3918555,8848292,8765781,8757,111422,2021-04-30 09:33:44.165,1828,122007,82511,8643774,497,2021-04-30 00:00:00.000,00:00,null,661
1.3938571,8883388,8798176,8466,112337,2021-05-01 09:17:27.172,1831,122634,85212,8675542,498,2021-05-01 00:00:00.000,00:00,null,627
1.3986067,8898234,8811627,8542,112865,2021-05-02 09:23:20.570,1833,123240,86607,8688387,499,2021-05-02 00:00:00.000,00:00,null,606
1.4018098,8915326,8826304,8538,113356,2021-05-03 09:31:59.949,1834,123728,89022,8702576,500,2021-05-03 00:00:00.000,00:00,null,488
1.399574,8957155,8879059,8301,114128,2021-05-04 09:46:01.635,1840,124269,78096,8754790,501,2021-05-04 00:00:00.000,00:00,null,541
1.4015026,8994069,8915074,8154,114944,2021-05-05 09:37:42.237,1847,124945,78995,8790129,502,2021-05-05 00:00:00.000,00:00,null,676
1.4049685,9010992,8933937,8177,115491,2021-05-06 09:34:55.519,1851,125519,77055,8808418,503,2021-05-06 00:00:00.000,00:00,null,574
1.4047879,9051354,8972458,8162,116022,2021-05-07 09:38:57.839,1860,126044,78896,8846414,504,2021-05-07 00:00:00.000,00:00,null,525
1.4065732,9089166,9010907,7999,116881,2021-05-08 09:37:54.141,1865,126745,78259,8884162,505,2021-05-08 00:00:00.000,00:00,null,701
1.4107056,9105771,9024491,8012,117423,2021-05-09 09:38:01.137,1874,127309,81280,8897182,506,2021-05-09 00:00:00.000,00:00,null,564
1.4136164,9122059,9038661,8053,117844,2021-05-10 09:36:30.350,1875,127772,83398,8910889,507,2021-05-10 00:00:00.000,00:00,null,463
1.4128509,9164284,9079656,7686,118717,2021-05-11 09:39:41.186,1879,128282,84628,8951374,508,2021-05-11 00:00:00.000,00:00,2021-05-27 09:53:30.741,510
1.4139994,9201539,9117260,7661,119373,2021-05-12 09:38:47.792,1884,128918,84279,8988342,509,2021-05-12 00:00:00.000,00:00,null,636
1.4161913,9241153,9153636,7836,119906,2021-05-13 09:41:10.700,1891,129633,87517,9024003,510,2021-05-13 00:00:00.000,00:00,null,715
1.419321,9281291,9186083,8092,120395,2021-05-14 09:44:47.494,1893,130380,95208,9055703,511,2021-05-14 00:00:00.000,00:00,null,747
1.4215047,9319094,9219878,7883,121282,2021-05-15 09:38:53.579,1896,131061,99216,9088817,512,2021-05-15 00:00:00.000,00:00,null,681
1.42579,9336614,9234951,8007,121764,2021-05-16 09:26:31.589,1900,131671,101663,9103280,513,2021-05-16 00:00:00.000,00:00,null,610
1.4299309,9353300,9251496,8224,122163,2021-05-17 09:39:34.169,1903,132290,101804,9119206,514,2021-05-17 00:00:00.000,00:00,null,619
1.429443,9395004,9291591,8283,122631,2021-05-18 09:41:35.393,1904,132818,103413,9158773,515,2021-05-18 00:00:00.000,00:00,null,528
1.4314549,9428644,9324150,8322,123237,2021-05-19 09:39:48.186,1912,133471,104494,9190679,516,2021-05-19 00:00:00.000,00:00,null,653
1.4361751,9447358,9338485,8542,123659,2021-05-20 09:35:45.542,1916,134117,108873,9204368,517,2021-05-20 00:00:00.000,00:00,2021-05-21 09:47:58.875,646
1.4368774,9487108,9372964,8598,124158,2021-05-21 09:36:32.023,1922,134678,114144,9238286,518,2021-05-21 00:00:00.000,00:00,null,561
1.4393079,9520966,9403408,8386,125032,2021-05-22 09:37:01.885,1926,135344,117558,9268064,519,2021-05-22 00:00:00.000,00:00,null,666
1.4438928,9536299,9414064,8117,125881,2021-05-23 09:37:54.099,1931,135929,122235,9278135,520,2021-05-23 00:00:00.000,00:00,null,585
1.4466269,9553613,9432909,8098,126427,2021-05-24 09:42:11.785,1934,136459,120704,9296450,521,2021-05-24 00:00:00.000,00:00,2021-05-26 17:11:27.494,530
1.4455504,9592727,9475629,8044,126993,2021-05-25 09:33:39.762,1938,136975,117098,9338654,522,2021-05-25 00:00:00.000,00:00,2021-05-26 17:26:57.787,516
1.4479226,9629450,9508381,8160,127574,2021-05-26 09:46:42.628,1940,137674,121069,9370707,523,2021-05-26 00:00:00.000,00:00,2021-05-27 09:40:52.468,699
1.4493399,9665693,9543034,8188,128180,2021-05-27 09:39:43.099,1943,138311,122659,9404723,524,2021-05-27 00:00:00.000,00:00,null,637
1.4499377,9702456,9579584,8193,128759,2021-05-28 09:34:29.553,1946,138898,122872,9440686,525,2021-05-28 00:00:00.000,00:00,2021-05-29 09:47:35.466,587
1.450925,9733591,9609801,7741,129739,2021-05-29 09:45:26.765,1951,139431,123790,9470370,526,2021-05-29 00:00:00.000,00:00,null,533
1.4541965,9747614,9621121,7572,130381,2021-05-30 09:24:39.384,1957,139910,126493,9481211,527,2021-05-30 00:00:00.000,00:00,null,479
1.456836,9761158,9633205,7558,130823,2021-05-31 09:34:29.254,1959,140340,127953,9492865,528,2021-05-31 00:00:00.000,00:00,null,430
1.4559203,9798402,9670790,7373,131463,2021-06-01 09:39:17.218,1963,140799,127612,9529991,529,2021-06-01 00:00:00.000,00:00,null,459
1.4576991,9834350,9705433,7443,132068,2021-06-02 09:34:39.577,1965,141476,128917,9563957,530,2021-06-02 00:00:00.000,00:00,null,677
1.4591427,9872324,9742502,7490,132699,2021-06-03 09:34:41.776,1968,142157,129822,9600345,531,2021-06-03 00:00:00.000,00:00,null,681
1.4610308,9911324,9777480,7594,133289,2021-06-04 09:35:01.747,1969,142852,133844,9634628,532,2021-06-04 00:00:00.000,00:00,null,695
1.4639522,9945954,9808790,7862,133763,2021-06-05 09:35:32.811,1971,143596,137164,9665194,533,2021-06-05 00:00:00.000,00:00,null,744
1.46746,9959697,9823232,7917,134262,2021-06-06 09:43:04.144,1973,144152,136465,9679080,534,2021-06-06 00:00:00.000,00:00,null,556
1.4705203,9972297,9835771,7802,134861,2021-06-07 09:34:49.979,1974,144637,136526,9691134,535,2021-06-07 00:00:00.000,00:00,null,485
1.470111,10008583,9869323,7703,135412,2021-06-08 09:37:18.147,1975,145090,139260,9724233,536,2021-06-08 00:00:00.000,00:00,2021-06-09 16:41:53.988,453
1.4696532,10044783,9913359,7541,136174,2021-06-09 09:41:30.049,1977,145692,131424,9767667,537,2021-06-09 00:00:00.000,00:00,null,602
1.4708941,10076862,9946535,7611,136713,2021-06-10 09:35:53.948,1979,146303,130327,9800232,538,2021-06-10 00:00:00.000,00:00,null,611
1.4719099,10111062,9977309,7652,137224,2021-06-11 09:37:57.985,1981,146857,133753,9830452,539,2021-06-11 00:00:00.000,00:00,2021-06-12 14:51:25.402,554
1.471522,10140535,10018335,7403,138037,2021-06-12 09:40:24.954,1982,147422,122200,9870913,540,2021-06-12 00:00:00.000,00:00,null,565
1.4745537,10152907,10028390,7308,138581,2021-06-13 09:36:35.692,1985,147874,124517,9880516,541,2021-06-13 00:00:00.000,00:00,null,452
1.4765178,10165497,10042073,7263,139022,2021-06-14 09:35:03.394,1988,148273,123424,9893800,542,2021-06-14 00:00:00.000,00:00,null,399
1.475716,10196469,10072805,6921,139733,2021-06-15 09:34:07.292,1992,148646,123664,9924159,543,2021-06-15 00:00:00.000,00:00,2021-06-16 09:46:35.159,373
1.475587,10229384,10110620,6760,140438,2021-06-16 09:52:02.014,1993,149191,118764,9961429,544,2021-06-16 00:00:00.000,00:00,null,545
1.4771445,10257836,10136517,6708,141029,2021-06-17 09:37:38.734,1994,149731,121319,9986786,545,2021-06-17 00:00:00.000,00:00,null,540
1.4775264,10294048,10168211,6426,141816,2021-06-18 09:42:02.100,1996,150238,125837,10017973,546,2021-06-18 00:00:00.000,00:00,null,507
1.478454,10323154,10194433,6338,142385,2021-06-19 09:54:16.488,1997,150720,128721,10043713,547,2021-06-19 00:00:00.000,00:00,null,482
1.481189,10335634,10204572,6248,142899,2021-06-20 09:39:22.589,2002,151149,131062,10053423,548,2021-06-20 00:00:00.000,00:00,null,429
1.4827924,10346047,10217614,6234,143268,2021-06-21 09:40:21.025,2004,151506,128433,10066108,549,2021-06-21 00:00:00.000,00:00,null,357
1.4815298,10380042,10252915,6077,143817,2021-06-22 09:37:35.096,2006,151900,127127,10101015,550,2021-06-22 00:00:00.000,00:00,2021-06-23 10:15:06.465,394
1.483878,10409949,10280158,6159,144379,2021-06-23 09:38:51.681,2007,152545,129791,10127613,551,2021-06-23 00:00:00.000,00:00,null,645
1.4843749,10438782,10317811,6359,144788,2021-06-24 09:34:00.179,2008,153155,120971,10164656,552,2021-06-24 00:00:00.000,00:00,null,610
1.4866946,10466545,10344357,6391,145389,2021-06-25 09:38:45.327,2009,153789,122188,10190568,553,2021-06-25 00:00:00.000,00:00,null,634
1.4878899,10495516,10380943,6456,145989,2021-06-26 09:46:37.249,2012,154457,114573,10226486,554,2021-06-26 00:00:00.000,00:00,null,668
